#^.^~****^*~~.~^~..~~~^~.^~.*~**.^^*^*^~..*^^..~^.
*#*~*.~^^^~~.*~*.**.~~^*^**.^~*^^.*^...^..^.**.~^*
^^#**~.*^*^..^**.~~~.~*.~^^~^~^.^~^*~**.~*^.^**.*.
*~~#~^.~*~^~^^*^**.~.*^^*~~^^*~.^.*^^*^.^.~~^^^*~.
*.^~#^.~^.^.^^*~^~~*^..^~^~~^.*^^..**.**~.~~^~*~**
^.^^~#.*~**.*~*^*~^*~~^.^.~.~^**~.^^^^*.~.~~~^^.^.
*~~.*.#~~~^*.^*~~~*^.^**^*^.^.^~~***^^*^.~^^.^^.~.
.~.*~~^#.**.~^^~**^.^.^~~~^.~.^~~^^.~^^.^^~.~.~.*^
.^^^~~*~#^.~.*~.~~..~*~^.~**~..^****~.*~^~~*~**^~^
^^^*^^**.##*.^^*^^^.*~*~^^~*~~.~****~~~~***.^^~~^~
..*^^^^^.^~#^~.^.^^~*~^*~**^*^.~~~*^.^^~**~*~.....
**.^~~~^~*~*#**.**^~.^.*^^^~.^...~.**^^^^~^.~^~.~*
^*~.*.~*^.~.^#^^^*~.**~^.*^*.~~..^~~~*~*^.~~^*^*^^
~*^.^..**~**^#^~***^~~*^*.*~..~^^***^.*~.^*^^^^.~.
*~^~^**^^*^^~^#~^^*~~~*^*~~~~*~^^^*~..~~~~~.*~^~*.
^.*.^*^**^^^~**#*.~^~~~^..~~~*~~^*~..^^.^~*.^~^~**
.***^..*^~~~~^~#*^~~.*.~^.^^*.***^~^.*....~.^.*~^^
^^~~~~.**.*.^^*#^~~^....*~*^~*^^.^~~~^*.~^^^~**^~~
^~~*^*.~.*^^^*^.##.~*...~**^.^^~.^^.^..^.^**.^^..*
~^***~^.~.~^^^*~~~#*..^~^^.~^.~.**...~^~**~^~~**^~
~~~^~.^*.^*.~*.*~~^#.~*^^~~**.*.*.~^^^..^.~^.*.^~~
^^~...^.*~.^^**~^~*.#^~^~*....^.^^**~.*.^^*..~*~.*
^..^...~.~.*.~***~*~~#..~*~^^~~^~**^~~^*^^~*.~*^*^
*^.**^~*****.~~~..~^~#*.^*~^.^^*^..*~^.^.^*.^.~^^*
~...~*^....*^.*^^*...^#~~..^.*~.*~.*^.^*^*^.****^~
^..~***^.*^~~.****.~*^#~.^~*.~^*^~^.****~..~*..*^~
.~^~**~^^..~~~^..*~*.^*#~..^^*.~.*..*~~*~.^~.~*~~.
.***~..~**^.~.~.~*.~~**.#^.^~..~*~~~~*.**~~^..^.^^
~.*.~^*^*~^.~*..*~^~~.*.*##*.*..^~.*~^^*.~^.^~^**^
.*^~^^*.^*.~*...*~~~*.**.~.##*.*^.^*.^*~*.^~^**^*.
.~..*....~..~.***~..~^..~~^*^#^~^^~~**^.*~**^**^^*
^.*.~.^.**^*^.~^^*.~..*^~*^***#~**..^.~~*..^*^~*.~
^~~^~~*.~^^~~^**.^.^^^*^.*^^~~.###~^*^^..**..**..^
^.^*.*^..*.~~.^^***^.*~..~.**^*.~^####^~*.~^~^..~~
~^^.^..*^^.**.~~^*~*^~*~^~~.~*.^~.~*^~#.*..^.^^*^*
^^.~*^~~*.~~*~.^..~*.^.~**.^*^.^~.**.~*#~...~~..*.
.~..^.~.~.^*.~^*~.~.*^*~~*.^.******~*~~#^~~~^.~~*~
~.*..^^*^~*.~~.~.^~..~.~^^^.*~*.**~^*~*^#^^~..^~^^
*.^*^**^*.^^*....**..~^^~.^*^.*~*^**^^..*##^*^^^.~
^*^~^^*.~*~^*~^~~.*.^*^~*^^~.*~.*~.**.*~^~~#~*^~~*
~~**~*.^.*~..~~^^^~^^^.~***^*.^*~^*~^~*~**.#.~..~.
*~**^~~.^.*.~^**~*^^.*^*.^~~*~~~*^.*..~~^*^#*^.^.*
.*^~..*~.*^^^^^~~^^*.~*.~~~.***~^.*..~~*****#~~^*.
.^^..^.^*^~^.~*...**~~~.**^*~~~*^***~^*^~^~~^#^*.*
**.**~.**~.*.*^~~.~^.*^.~~*.^*.~.***~*^^..~*.~#^*^
~..^.****^.****~^~***..^^^^*^.~*^^*.~~.^**^*~^*#~~
^*~^.~*...^^.^~.^^..~^...**...^****^*~*~*^..~^*~#~
...^~^.~^^~~~~.*^~.^~***~~^^^.*^^.~.^*~*~**^***^~#
.~~~~~^^.~~*^.~^^^**~^~.^~^~*..^*~^^*..*~^~**.*.^#
~^**.~**..*^~^^^.^*^~^~*^.~*~.^.**.^.^^.~**^~~^~^#